00000000
01111110
01110100
01011100
01111110
01111110
01011100
00000000